Flight No - Origin - Dest

TG621 - MNL - BKK
PR312 - MNL - HKG
CX709 - HKG - BKK

5J907 - MNL - CEB
PR612 - DVO - CRK
Z2321 - CRK - CEB

---

Flight Class

Y: Full-fare economy-class ticket.
J: Full-fare business-class ticket.
F: Full-fare first-class ticket.

---

Flight Type

D: Domestic Flights
I: International Flights

---

Area Options

B: Bulkhead seat
W: Window seat
A: Aisle seat

---

Specific Passenger Options

I: Infant
U: Unaccompanied Minor
H: Handicapped
M: Medically OK for travel

ADT: Adult
CHD: Child
UNN: Unaccompanied Child
UNMR: Unaccompanied Minor
INF: Infant without a seat
INS: Infant with a seat
SRC: Senior Citizen

src: https://support.travelport.com/webhelp/uapi/Content/Air/Shared_Air_Topics/Passenger_Type_Codes.htm

---

OW: One way trip
RT: Round trip